1111111111111
1000100010001
1010100100111
1000110000001
1110000101101
1000100101111
1111111111111